############
#.......M..#
#.M........#
#....P.....#
#..........#
#.......P..#
############
