############
#.......M..#
#.M........###########
#....P...............#
#..........######.M..#
#.......P..#    #....#
#####.######    ######
    #.#
    #.#
    #.#
#####.################
#....................#
#......M.....M.......#
#....................#
######################
