############
#.......M..#
#.M........###########
#....PE..............#
#..........######.M..#
#.......P..#    #....#
#####...####    ######
    #...#
    #...#
    #...#
#####...##############
#....................#
#......M.....M...S...#
#....................#
######################
