########################
#..E..#................#
#.....#................#
#..#..#######..######..#
#..#..#.............#..#
#..#..#.............#..#
#.....############..#..#
#.....#..........#..#..#
#..#..#..........#..#..#
#..#..#..#....#..#..#..#
#..#..#..#....#..#..#..#
#..#..#..######..#..#..#
#..#..#.......#..#..#..#
#..#..#.......#..#.....#
#..#..#..#.S..#..#.....#
#..#..#..######..#..#..#
#..#..#..........#..#..#
#..#..#..........#..#..#
#..#..#####..#####..#..#
#..#................#..#
#..#................#..#
#..##################..#
#......................#
#......................#
########################