#########      #########
#...E...########.......#
#......................#
#......................#
#.......########.......#
#.......#      #.......#
#.......########.......#
#......................#
#......................#
####################...#
                   #.P.#
####################...#
#......................#
#...####################
#.M.#
#...####################
#......................#
#......................#
#.......########.......#
#.......#      #.......#
#.......########.......#
#......................#
#......................#
#.......########...S...#
#########      #########