############
#M......M.M#
#.M........###########
#....PE..............#
#..........######.M..#
#M......P.M#    #....#
#####...####    ######
    #...#
    #...#
    #...#
#####...##############
#....................#
#......M.....M...S...#
#....................#
######################
