############
#M......M.M#
#.M........###########
#.....E..............#
#........P.######.M..#
#M....P.PPM#    #....#
#####...####    ######
    #.P.#
    #...#
    #...#
#####...##############
#....................#
#..P...M.....M...S...#
#....................#
######################
